dados/tilemaps/TileSets/TileSetCenario.png
16 16

# caminhavel
*
1 1 1 1 1 1 1 0 0 0 0 1 1 1 1 1
0 1 1 1 1 1 1 1 0 0 0 1 1 1 1 1
0 1 1 1 1 1 1 1 0 0 0 1 1 1 1 1
1 1 1 1 1 0 1 1 1 1 1 1 1 1 1 1
1 1 1 1 1 0 0 0 0 0 0 1 1 1 1 1
0 1 1 1 1 0 0 0 0 0 0 1 1 1 1 1
1 1 1 1 1 0 0 0 0 0 0 1 1 1 1 1
0 1 1 1 1 0 0 0 1 1 1 1 1 1 1 1
0 1 1 1 1 0 0 0 1 1 0 0 0 1 1 0
1 1 1 1 1 0 0 0 0 0 0 0 0 1 0 0
1 1 1 1 1 0 0 0 0 0 0 0 0 1 1 0
1 1 1 1 1 0 0 0 1 1 1 1 0 0 0 0
1 1 1 1 1 0 0 0 1 1 1 1 0 1 0 0
1 1 1 1 1 1 1 1 1 1 1 1 0 1 0 0
1 1 1 1 1 1 1 1 1 1 1 1 0 1 0 0

# nivel
*
0 0 0 0 0 0 0 1 0 0 0 0 0 0 0 0
1 0 0 0 0 0 0 0 0 0 0 0 0 0 0 0
1 0 0 0 0 0 0 0 0 0 0 0 0 0 0 0
0 0 0 0 0 1 0 0 0 0 0 0 0 0 0 0
0 0 0 0 0 0 0 0 0 0 0 0 0 0 0 0
1 0 0 0 0 0 0 0 0 0 0 0 0 0 0 0
0 0 0 0 0 0 0 0 0 0 0 0 0 0 0 0
1 0 0 0 0 0 0 0 0 0 0 0 0 0 0 0
1 0 0 0 0 0 0 0 1 1 1 1 1 0 0 1
0 0 0 0 0 0 0 0 1 1 1 1 1 0 0 1
0 0 0 0 0 1 1 1 0 0 1 1 1 0 0 1
0 0 0 0 0 1 0 1 0 0 0 0 0 0 0 1
0 0 0 0 0 1 1 1 0 0 0 0 0 0 0 1
0 0 0 0 0 0 0 0 0 0 0 0 0 0 0 1
0 0 0 0 0 0 0 0 0 0 0 0 0 0 0 0

# custo adicional
*
0 0 0 0 0 0 0 0 0 0 0 0 0 0 0 0
0 0 0 0 0 0 0 0 0 0 0 0 0 0 0 0
0 0 0 0 0 0 0 0 0 0 0 0 0 0 0 0
0 0 0 0 0 0 0 0 0 0 0 0 0 0 0 0
0 0 0 0 0 0 0 0 0 0 0 0 0 0 0 0
0 0 0 0 0 0 0 0 0 0 0 0 0 0 0 0
0 0 0 0 0 0 0 0 0 0 0 0 0 0 0 0
0 0 0 0 0 0 0 0 0 0 0 0 0 0 0 0
0 0 0 0 0 0 0 0 0 0 0 0 0 0 0 0
0 0 0 0 0 0 0 0 0 0 0 0 0 0 0 0
0 0 0 0 0 0 0 0 0 0 0 0 0 0 0 0
0 0 0 0 0 0 0 0 0 0 0 0 0 0 0 0
0 0 0 0 0 0 0 0 0 0 0 0 0 0 0 0
0 0 0 0 0 0 0 0 0 0 0 0 0 0 0 0
0 0 0 0 0 0 0 0 0 0 0 0 0 0 0 0