dados/tilemaps/Tilesets/Tileset.png
32 32

# caminhavel
*
1 1 1 1 1 1 1 1
1 1 1 1 1 1 1 0
1 1 1 0 0 0 0 1
0 0 0 0 0 0 0 1
0 0 0 0 0 0 0 1
0 0 0 0 0 0 1 1

# nivel
*
0 0 0 0 0 0 0 0
0 0 0 0 0 0 0 1
0 0 0 1 1 1 1 0
1 1 1 1 1 1 1 0
1 1 1 1 1 1 1 0
1 1 1 1 1 1 0 0

# custo adicional
*
0 0 0 0 0 0 0 0
0 0 0 0 0 0 0 0
0 0 0 0 0 0 0 0
0 0 0 0 0 0 0 0
0 0 0 0 0 0 0 0
0 0 0 0 0 0 0 0
